##########
#        #
#  $    .#
# #  $ . #
# ###   .#
#   # ####
#   #$#  #
#       @#
#        #
##########