  ####
###  ####
#     . #
# #   $ #
#     @ #
#########