+---------+
|         |
|O -| | - |
|   | |   |
| --+ +-+ |
|    x    |
+---------+