###########
#         #
#. ## # # #
#   # #   #
# ### ### #
#    @    #
###########