##########
#   @    #
#   # #  #
#   # #  #
#    @   #
##########