##########
#   M    #
#  D# #  #
#   # #  #
#    P D #
##########