##############################
#                            #
#  #         # ##            #
# .####         #            #
####            #        #####
#    #            #          #
#  ###         ####          #
#  #           #             #
#    #               @@@     #
#                            #
#  #         # ##            #
#  #         # ##            #
#  #         # ##            #
# .####         #            #
####            #        #####
#    #            #          #
#  ###         ####         @#
#  #           #             #
#    #                       #
##############################
