##########
#   M    #
#  D# #  #
#   # #  #
#    P   #
##########