###############
#             #
#  #  # ##    #
# .#### #     #
####    # #####
#    #    #   #
#  ### ####  @#
#  #   #      #
#    #        #
###############
